11111111111111111111111111111111111111
12000000000000000000000000000000000001
10000000000000000000000000000000000001
11111111111111111111111111111000000001
10000000000000000000000000001000000001
10000000000000000000000000001000000001
10000000000000000000000000001000000001
10000000000100000000000000001000000001
10000000000100000000000000001000000001
10000000000100000000000000001000000001
10000000000100000000000000000000000001
10000000000100000000000000000000000001
10000000000111111111111111111111111111
10000000000000000000000000000000000001
10000000000000000000000000000000000001
10000000000000000000000000000000000001
11111111111111111111111111100000000001
10000000000000000000000000000000000001
10000000000000000000000000000000000001
10000000000000000000000000000000000001
10000000011111111111111111111111111111
10000000010000000000000000000000000001
10000000010000000000000000000000000001
10000000010000001111111111110000000001
10000000010000001300000000010000000001
10000000010000001000000000010000000001
10000000010000001111110000010000000001
10000000010000000000000000010000000001
10000000010000000000000000010000000001
10000000010000000000000000010000000001
10000000011111111111111111110000000001
10000000000000000000000000000000000001
10000000000000000000000000000000000001
10000000000000000000000000000000000001
11111111111111111111111111111111111111